NO assets/textures/north_wall.xpm
SO assets/textures/south_wall.xpm
WE assets/textures/west_wall.xpm
EA assets/textures/east_wall.xpm

F 0,128,0
C 255,255,255

11111111111111111111111111111111111111111111111111
10000000000000000000000000000000000000000000000001
10000000000000000000000000000000000000000000000001
10000000000000000000000000000000000000000000000001
10001111111111111111111111111111111111111111100001
10001000000000000000000000000000000000000001100001
10001000000000000000000000000000000000000001100001
10001000000000000000000000000000000000000001100001
10001000000000000000000000000000000000000001100001
10001000000000000000000000000000000000000001100001
10001000000000000000000000000000000000000001100001
10001000000000000000000000000000000000000001100001
10001000000000000000000000000000000000000001100001
10001000000000000W00000000000000000000000001100001
10001000000000000000000000000000000000000001100001
10001000000000000000000000000000000000000001100001
10001000000000000000000000000000000000000001100001
10001000000000000000000000000000000000000001100001
10001000000000000000000000000000000000000001100001
10001000000000000000000000000000000000000001100001
10001000000000000000000000000000000000000001100001
10001111111111111111111111111111111111111111100001
10000000000000000000000000000000000000000000000001
10000000000000000000000000000000000000000000000001
10000000000000000000000000000000000000000000000001
11111111111111111111111111111111111111111111111111
