NO assets/textures/soul_sand.xpm
SO assets/textures/soul_soil.xpm
WE assets/textures/soul_soil_01.xpm
EA assets/textures/netherrack_01.xpm

C 0, 0, 0
F 41, 43, 63

        1111111111111111111111111
        1000000000110000000000001
        1011000001110000000000001
        1001000000000000000000001
111111111011000001110000000000001
100000000011000001110111111111111
11110111111111011100000010001
11110111111111011101010010001
1100000011010101110N000010001
10000000000000001100000010001
10000000000000001101010010001
1100000111010101111101111000111
11110111 1110101 101111010001
11111111 1111111 111111111111
