NO assets/textures/north_wall.xpm
SO assets/textures/south_wall.xpm
WE assets/textures/west_wall.xpm
EA assets/textures/east_wall.xpm

F 255,0,0
C 0,0,255

0111111
1000001
1000N01
1000001
1111110
