NO assets/textures/basalt_top.xpm
SO assets/textures/basalt_top.xpm
WE assets/textures/basalt_top.xpm
EA assets/textures/basalt_top.xpm

C 0, 0, 0
F 41, 43, 63

111111111111111111111111111111
1N0000000000000000000000000001
101111111111111111111111110101
100000000000000000000000000101
100100110111111111111111111101
100100110000000000000000000101
101111011111111111111111110101
100000011111111111111111110101
100001011111111111111111110101
111111000000000000000000000001
111111111111111111111111111111
