NO assets/textures/north_wall.xpm
SO assets/textures/south_wall.xpm
WE assets/textures/west_wall.xpm
EA assets/textures/east_wall.xpm

F 0,0,0
C 255,255,255

1111111111111111111111111111111111111111111111111111
100S000000000000000000000000000000000000000000000001
1111111111111111111111111111111111111111111111111111
1000000000000000000000000000000000000000000000000001m
100S000000000000000000000000000000000000000000000001
1001001000000000000000000000000000000000000000000001
1001001000000000000000000000000000000000000000000001
1001001000000000000000000000000000000000000000000001
1001001000000000000000000000000010010100000000000001
1001001000000000000000000000000010010100000000000001
1001001000000000000000000000000010010100000000000001
1001001000000000000000000000000010010100000000000001
1001001000000000000000000000000010010100000000000001
1001001000100100000000000000000010010100000000000001
1001001000100100000000000000000010010100000000000001
1001001000100100000000000000000010010100000000000001
1001001111100111111111111111111110001111111111111111
1001000000000000000000000000000000000000000000000001
1111111111111111111111111111111111111111111111111111
