NO assets/textures/cobblestone.xpm
SO assets/textures/cobblestone.xpm
WE assets/textures/cobblestone.xpm
EA assets/textures/cobblestone.xpm

F 252, 234, 73
C 0,0,0

11111111111111111111111111111111111111111111111111
10000000000000000000000000000000000000000000000001
10000000000000000000000000000000000000000000000001
10000000000000000000000000000000000000000000000001
10001111111111111111111111111111111111111111100001
10001000000000000000000000000000000000000001100001
10001000000000000000000000000000000000000001100001
10001000000000000000000000000000000000000001100001
10001000000000000000000000000000000000000001100001
10001000000000000000000000000000000000000001100001
10001000000000000000000000000000000000000001100001
10001000000000000000000000000000000000000001100001
10001000000000000000000000000000000000000001100001
10001000000000000010000000000000000000000001100001
10001000000000000010111111111111111111000001100001
10001000000000000010100000000000000000000001100001
10001000000000000010100000000000000000000001100001
10001000000000000010100000000000000000000001100001
10001000000000000010100000000000000000000001100001
10001000000000000010100000000000000000000001100001
1000100000000000001010000000000000000000000110S001
10001111111111111110111111111111111111111111100001
10000000000000000010000000000000000000000000000001
11110111111111111111111111111111111111111111100001
10000000000000000000000000000000000000000000000001
11111111111111111111111111111111111111111111111111
