NO textures/north_wall.xpm
SO textures/south_wall.xpm
WE textures/west_wall.xpm
EA textures/east_wall.xpm

F 255,0,0
C 0,0,255

1111111
1N00N01
1000001
1000001
1111111
